111111111111111111111111
1P0000000000000000000001
100010001000010001000001
100000C000000C000000C001
100010001000010001000001
100000000000000000000001
100010001000010001000001
10000C0000000000000000E1
100010001000010001000001
100000000C00000000000001
100010001000010001000001
100000000000000000000001
100010001000010001000001
100000000000000000000001
111111111111111111111111